Mixed Reality im Fieldservice: Wie Siemens mit der HoloLens den Güterverkehr revolutionierte
Lebenslauf retten: 7 Bewerbungstipps für Job-Hopper
Enterprise Architecture bei Schaeffler: &quot;Wir stellen keine Stoppschilder mehr auf&quot;
Augmented Reality: Lego plant AR-Spiel &quot;Hidden Side&quot; für Android und iOS
IT-Architektur: Checkliste für eine IoT-Referenzarchitektur
Chatbot, RPA und KI wachsen zusammen: Actbots automatisieren Standardtransaktionen
Position neu geschaffen: CIO Wiedenmann wechselt von Ledvance zu Atotech
SD-WAN: Wie Cloud-optimierte Netzwerkarchitektur geht
Do&apos;s und Dont&apos;s: Smalltalk-Fehler vermeiden
Sicherheit für Industrie 4.0: Sichere Smart Factory trotz alter Anlagen?
Elf Millionen Betroffene: 5 Wege aus der E-Mail-Sucht
BMW, Daimler, Volkswagen: Spracherkennung verbessert die Customer Experience
FAQ: Ausschlussfristen im Arbeitsrecht: Ausschlussfristen im Arbeitsvertrag
Südwestdeutsche Medienholding: Jens Kessler wird CTO der Mediengruppe SWMH
Offener Standard für AI: So flexibel lassen sich ML-Modelle mit ONNX trainieren und einsetzen
5 Tipps für Collaboration: Virtuelle Teams erfolgreich führen
Intelligent Enterprise: SAP baut seine IoT-Aktivitäten weiter aus
CIO-Jahrbuch 2019: Die IT-Fakten der größten deutschen Konzerne
Agiles Unternehmen: Alte Management-Methoden reichen nicht mehr
Neue KI- und Edge-Computing-Lösungen: Siemens erweitert Digital-Enterprise-Angebot
WLAN-Bestellknöpfe für Waren: Amazon schafft den &quot;Dash&quot;-Button ab
Flixbus-Alternative: Blablacar startet Fernbus-Angebot Blablabus in Deutschland
Händler und Probefahrt fallen weg: Tesla verlagert Verkauf komplett ins Internet
Seitenhiebe gegen BMW: Sixt verschmilzt Autovermietung und Carsharing
Heimtierbedarfskette: Fressnapf will mehr als nur Tierfutter verkaufen
Fuchs-Gruppe: Gewürzproduzent Dieter Fuchs ist tot
Changan Ford: Ford baut Tausende Arbeitsplätze in China ab
Neuer Digital-Chef: Otto Group CDO will Tech-Ausbau beschleunigen
Automatisiertes Fahren: BMW und Daimler bündeln noch mehr Kräfte
Cloud-Dienste: Microsoft und Volkswagen vertiefen die Zusammenarbeit
Strategische Option: Wabco bestätigt Gespräche mit ZF Friedrichshafen
Sony-Mobilfunkchef: Sony will im Smartphone-Markt nicht aufgeben
Fachkräfte aus der Bundeswehr: Unternehmen werben um Soldaten
Bundesfinanzhof: Kein Dienstwagen für Ehefrau mit Minijob
Laufzeit-Messung für Deutsche Post: Post-Kritiker nehmen Briefversand unter die Lupe
Daimler CEO auf dem MWC: Zetsche: &quot;Ohne Wandel sind wir erledigt&quot;
Tochter der Bank of America: Merrill Lynch verschwindet
OLG Schleswig: Mediamarkt scheitert mit Klage gegen Ex-Deutschlandchef
Zwei Gebote: Kaufverhandlungen zu insolventer Airline Germania
Opel News: Opel erwirtschaftet Gewinn
User Group „Riester-Rente"
Werden Sie Aussteller
Hauptsponsoren
Erfahrungsaustausch Product Oversight Governance (POG)
Messekongress „Schadenmanagement & Assistance“
Innovationswerkstatt Lebenswelten
Fokustag "Ambient Assisted Living"
User Group „Strategische Handlungsfelder für Assekuradeure“
Nutzen Sie das Unternehmensticket
Werden Sie Aussteller
Sichern Sie sich Ihren Preisvorteil!
CRM in der Versicherungswirtschaft
Online Weiterbildung für die Assekuranz!
User Group Maklerbetreuung
Messekongress IT für Versicherungen!
Heimnetz &amp; LAN: So richten Sie Ihre Fritzbox richtig ein
Unternehmensverkauf: Was eine IT-Firma wert ist
Tipps für Führungskräfte: Die größten Anfängerfehler als Chef
Digitaler Nachlass: Was mit den Online-Daten Verstorbener geschieht
System-Tools: Die besten One-Click-Tools für Faule
Intel bestätigt: iPhones 2019 noch ohne 5G
Autodidakt oder Troubleshooter: So unterscheiden sich IT-Experten
Gap-Analyse (Lückenanalyse): So profitiert Ihr Unternehmen von einer Gap-Analyse
Smartphone: Die besten Akku-Apps für Android
Foto, SLR &amp; Camcorder: 40 geniale Gratis-Tools für Bildbearbeitung
Der Wettbewerb ist eröffnet: Jetzt mitmachen beim Digital Leader Award 2019
Gesucht: (Junior) Sales Manager (w/m/d)
ANC-Kopfhörer: Microsofts Surface-Kopfhörer im Test
AWS Summit 2019: Amazon Web Services launcht Mammut-Instanzen für S/4HANA
Bewerbung bis zum 10. April: Erfinderinnenpreis geht in die nächste Runde
Motorola RAZR reloaded: Motorola bestätigt faltbares Smartphone für 1500 Dollar
Mit nachhaltigem Design Datenschätze heben: Wie &quot;künstlich&quot; ist die Intelligenz im Finanzsektor
Künstliche Intelligenz: Macht KI ERP-Systeme schlauer?
Tipps zu Microsofts Tabellenkalkulation: Die besten Tipps und Tricks zu Excel 2013
Low Code Development: Die smarte Lösung für IT-Fachkräftemangel
